萬里分館	ZA
萬里視聽室	ZA
萬里開架閱	ZA
萬里借書櫃	ZA
萬里罕用書	ZA
萬里兒童室	ZA
萬里本土語	ZA
萬里期刊室	ZA
萬里參考室	ZA
萬里樂齡專	ZA
萬里特色專	ZA
萬里辦公室	ZA
萬里限制級	ZA
萬里校園C	ZA
萬里分館取	ZA
金山分館	WA
金山視聽室	WA
金山開架閱	WA
金山心靈閱	WA
金山借書櫃	WA
金山幸福家	WA
金山罕用書	WA
金山兒童室	WA
金山本土語	WA
金山期刊室	WA
金山參考室	WA
金山樂齡專	WA
金山特色專	WA
金山辦公室	WA
金山限制級	WA
金山分館取	WA
板橋分館	TA
板橋視聽室	TA
板橋開架閱	TA
板橋借書櫃	TA
板橋罕用書	TA
板橋兒童室	TA
板橋本土語	TA
板橋期刊室	TA
板橋參考室	TA
板橋特色專	TA
板橋辦公室	TA
板橋限制級	TA
板橋分館取	TA
總館	TB
總館9樓全	TB
總館5樓視	TB
總館5樓視	TB
總館9樓大	TB
總館開架閱	TB
總館6樓開	TB
總館7樓開	TB
總館8樓開	TB
總館4樓漫	TB
總館1樓借	TB
總館4樓展	TB
總館1樓展	TB
總館7F主	TB
總館8F主	TB
總館3樓展	TB
總館6F主	TB
總館6樓四	TB
總館3樓幸	TB
總館8樓政	TB
總館7樓性	TB
總館4樓閉	TB
總館6樓閉	TB
總館7樓閉	TB
總館8樓閉	TB
總館8樓悅	TB
總館3樓兒	TB
總館9樓多	TB
總館8F本	TB
總館2樓期	TB
總館3樓兒	TB
總館4樓期	TB
總館4樓新	TB
總館9樓參	TB
總館2樓期	TB
總館9樓文	TB
總館2樓樂	TB
總館8樓簡	TB
總館9樓特	TB
總館9樓新	TB
總館8樓悅	TB
總館10樓	TB
總館1樓視	TB
總館1樓限	TB
總館4樓青	TB
總館校園C	TB
總館取書	TB
總館班級書	TBZ3
板橋江子翠	TC
板橋江子翠	TC
板橋江子翠	TC
板橋江子翠	TC
板橋江子翠	TC
板橋江子翠	TC
板橋江子翠	TC
板橋江子翠	TC
板橋江子翠	TC
板橋江子翠	TC
板橋江子翠	TC
板橋江子翠	TC
板橋江子翠	TC
板橋國光圖	TD
板橋國光視	TD
板橋國光開	TD
板橋國光借	TD
板橋國光罕	TD
板橋國光兒	TD
板橋國光期	TD
板橋國光參	TD
板橋國光特	TD
板橋國光辦	TD
板橋國光限	TD
板橋國光圖	TD
板橋四維分	TE
板橋四維3	TE
板橋四維3	TE
板橋四維3	TE
板橋四維1	TE
板橋四維2	TE
板橋四維2	TE
板橋四維2	TE
板橋四維3	TE
板橋四維2	TE
板橋四維B	TE
板橋四維2	TE
板橋四維2	TE
板橋四維2	TE
板橋四維2	TE
板橋四維2	TE
板橋四維2	TE
板橋四維2	TE
板橋四維3	TE
板橋四維2	TE
板橋四維2	TE
板橋四維3	TE
板橋四維2	TE
板橋四維3	TE
板橋四維3	TE
板橋四維3	TE
板橋四維特	TE
板橋四維2	TE
板橋四維1	TE
板橋四維校	TE
板橋四維分	TE
板橋民生圖	TF
板橋民生視	TF
板橋民生開	TF
板橋民生借	TF
板橋民生兒	TF
板橋民生期	TF
板橋民生參	TF
板橋民生樂	TF
板橋民生辦	TF
板橋民生限	TF
板橋民生圖	TF
板橋忠孝分	TG
板橋忠孝視	TG
板橋忠孝開	TG
板橋忠孝借	TG
板橋忠孝罕	TG
板橋忠孝兒	TG
板橋忠孝期	TG
板橋忠孝參	TG
板橋忠孝特	TG
板橋忠孝辦	TG
板橋忠孝限	TG
板橋忠孝分	TG
板橋溪北分	TH
板橋溪北視	TH
板橋溪北開	TH
板橋溪北借	TH
板橋溪北兒	TH
板橋溪北期	TH
板橋溪北參	TH
板橋溪北特	TH
板橋溪北辦	TH
板橋溪北限	TH
板橋溪北分	TH
板橋浮洲圖	TI
板橋浮洲視	TI
板橋浮洲開	TI
板橋浮洲借	TI
板橋浮洲罕	TI
板橋浮洲兒	TI
板橋浮洲期	TI
板橋浮洲參	TI
板橋浮洲辦	TI
板橋浮洲限	TI
板橋浮洲圖	TI
板橋萬板親	TJ
板橋萬板視	TJ
板橋萬板開	TJ
板橋萬板借	TJ
板橋萬板兒	TJ
板橋萬板期	TJ
板橋萬板參	TJ
板橋萬板兒	TJ
板橋萬板辦	TJ
板橋萬板限	TJ
板橋萬板親	TJ
市府大樓閱	TK
市府閱讀小	TK
環狀線板橋	TS
總館自助取	TT
板橋車站智	TU
板橋車站智	TU
板橋車站智	TU
板橋車站智	TU
板橋車站智	TU
板橋車站智	TU
板橋車站智	TU
板橋車站智	TU
板橋車站智	TU
板橋車站智	TU
板橋車站智	TU
板橋車站智	TU
板橋車站智	TU
板橋車站智	TU
板橋車站智	TU
板橋車站智	TU
板橋車站智	TU
板橋車站智	TU
板橋車站智	TU
板橋車站智	TU
板橋車站智	TU
板橋車站智	TU
板橋車站智	TU
板橋車站智	TU
板橋車站智	TU
板橋車站智	TU
板橋車站智	TU
板橋車站智	TU
板橋車站智	TU
板橋車站智	TU
板橋車站智	TU
板橋車站智	TU
板橋車站智	TU
板橋車站智	TU
總館行動書	TW
汐止大同閉	YA
汐止大同閉	YA
汐止大同閉	YA
汐止大同閉	YA
汐止大同閉	YA
汐止新昌分	YB
汐止新昌視	YB
汐止新昌開	YB
汐止新昌借	YB
汐止新昌罕	YB
汐止新昌兒	YB
汐止新昌期	YB
汐止新昌參	YB
汐止新昌辦	YB
汐止新昌限	YB
汐止北峰圖	YC
汐止北峰視	YC
汐止北峰開	YC
汐止北峰借	YC
汐止北峰罕	YC
汐止北峰兒	YC
汐止北峰期	YC
汐止北峰參	YC
汐止北峰辦	YC
汐止北峰限	YC
汐止北峰圖	YC
汐止茄苳分	YD
汐止茄苳視	YD
汐止茄苳開	YD
汐止茄苳借	YD
汐止茄苳兒	YD
汐止茄苳期	YD
汐止茄苳參	YD
汐止茄苳辦	YD
汐止茄苳限	YD
汐止茄苳分	YD
汐止江北分	YE
汐止江北視	YE
汐止江北開	YE
汐止江北借	YE
汐止江北罕	YE
汐止江北兒	YE
汐止江北期	YE
汐止江北參	YE
汐止江北辦	YE
汐止江北限	YE
汐止江北分	YE
汐止分館	YF
汐止分館視	YF
汐止分館開	YF
汐止分館借	YF
汐止分館兒	YF
汐止分館期	YF
汐止分館參	YF
汐止分館樂	YF
汐止分館特	YF
汐止分館辦	YF
汐止分館限	YF
汐止校園C	YF
汐止分館取	YF
汐止長安分	YG
汐止長安視	YG
汐止長安開	YG
汐止長安借	YG
汐止長安兒	YG
汐止長安期	YG
汐止長安參	YG
汐止長安特	YG
汐止長安辦	YG
汐止長安限	YG
汐止長安分	YG
汐止橫科圖	YH
汐止橫科視	YH
汐止橫科開	YH
汐止橫科借	YH
汐止橫科罕	YH
汐止橫科兒	YH
汐止橫科本	YH
汐止橫科期	YH
汐止橫科參	YH
汐止橫科辦	YH
汐止橫科限	YH
汐止橫科圖	YH
汐止大同分	YI
汐止大同分	YI
汐止大同分	YI
汐止大同分	YI
汐止大同分	YI
汐止大同分	YI
汐止大同分	YI
汐止大同分	YI
汐止大同分	YI
汐止大同分	YI
汐止大同分	YI
汐止大同分	YI
深坑分館	RA
深坑視聽室	RA
深坑開架閱	RA
深坑借書櫃	RA
深坑罕用書	RA
深坑兒童室	RA
深坑本土語	RA
深坑期刊室	RA
深坑參考室	RA
深坑樂齡專	RA
深坑特色專	RA
深坑辦公室	RA
深坑限制級	RA
深坑分館取	RA
石碇分館	SA
石碇視聽室	SA
石碇開架閱	SA
石碇借書櫃	SA
石碇罕用書	SA
石碇兒童室	SA
石碇本土語	SA
石碇期刊室	SA
石碇參考室	SA
石碇樂齡專	SA
石碇特色專	SA
石碇辦公室	SA
石碇限制級	SA
石碇分館取	SA
瑞芳分館	ZC
瑞芳視聽室	ZC
瑞芳開架閱	ZC
瑞芳借書櫃	ZC
瑞芳罕用書	ZC
瑞芳兒童室	ZC
瑞芳本土語	ZC
瑞芳期刊室	ZC
瑞芳參考室	ZC
瑞芳樂齡專	ZC
瑞芳特色專	ZC
瑞芳辦公室	ZC
瑞芳限制級	ZC
瑞芳校園C	ZC
瑞芳分館取	ZC
瑞芳東和圖	ZG
瑞芳東和視	ZG
瑞芳東和開	ZG
瑞芳東和借	ZG
瑞芳東和兒	ZG
瑞芳東和期	ZG
瑞芳東和參	ZG
瑞芳東和辦	ZG
瑞芳東和限	ZG
瑞芳東和圖	ZG
平溪分館	MA
平溪視聽室	MA
平溪開架閱	MA
平溪借書櫃	MA
平溪幸福家	MA
平溪兒童室	MA
平溪本土語	MA
平溪期刊室	MA
平溪參考室	MA
平溪樂齡專	MA
平溪特色專	MA
平溪辦公室	MA
平溪限制級	MA
平溪分館取	MA
雙溪分館	XA
雙溪視聽室	XA
雙溪開架閱	XA
雙溪借書櫃	XA
雙溪幸福家	XA
雙溪罕用書	XA
雙溪兒童室	XA
雙溪本土語	XA
雙溪期刊室	XA
雙溪參考室	XA
雙溪樂齡專	XA
雙溪特色專	XA
雙溪辦公室	XA
雙溪限制級	XA
雙溪分館取	XA
貢寮分館	ZD
貢寮視聽室	ZD
貢寮開架閱	ZD
貢寮借書櫃	ZD
貢寮兒童室	ZD
貢寮本土語	ZD
貢寮期刊室	ZD
貢寮參考室	ZD
貢寮樂齡專	ZD
貢寮特色專	ZD
貢寮辦公室	ZD
貢寮限制級	ZD
貢寮分館取	ZD
新店分館	QA
新店原住民	QA
新店視聽室	QA
新店開架閱	QA
新店借書櫃	QA
新店罕用書	QA
新店兒童室	QA
新店期刊室	QA
新店參考室	QA
新店特色專	QA
新店辦公室	QA
新店限制級	QA
新店校園C	QA
新店分館取	QA
新店寶興圖	QB
新店寶興視	QB
新店寶興開	QB
新店寶興借	QB
新店寶興罕	QB
新店寶興兒	QB
新店寶興期	QB
新店寶興參	QB
新店寶興辦	QB
新店寶興限	QB
新店寶興圖	QB
新店北新圖	QC
新店北新視	QC
新店北新開	QC
新店北新借	QC
新店北新罕	QC
新店北新兒	QC
新店北新期	QC
新店北新參	QC
新店北新辦	QC
新店北新限	QC
新店北新圖	QC
新店中央圖	QD
新店中央視	QD
新店中央開	QD
新店中央借	QD
新店中央罕	QD
新店中央兒	QD
新店中央期	QD
新店中央參	QD
新店中央辦	QD
新店中央限	QD
新店中央圖	QD
新店碧潭圖	QE
新店碧潭視	QE
新店碧潭開	QE
新店碧潭借	QE
新店碧潭罕	QE
新店碧潭兒	QE
新店碧潭期	QE
新店碧潭參	QE
新店碧潭辦	QE
新店碧潭限	QE
新店碧潭圖	QE
新店日興[	QF
新店日興視	QF
新店日興開	QF
新店日興借	QF
新店日興罕	QF
新店日興兒	QF
新店日興期	QF
新店日興參	QF
新店日興辦	QF
新店日興限	QF
新店百忍圖	QG
新店百忍視	QG
新店百忍開	QG
新店百忍借	QG
新店百忍罕	QG
新店百忍兒	QG
新店百忍期	QG
新店百忍參	QG
新店百忍辦	QG
新店百忍限	QG
新店百忍圖	QG
新店福民圖	QH
新店福民視	QH
新店福民開	QH
新店福民借	QH
新店福民罕	QH
新店福民兒	QH
新店福民期	QH
新店福民參	QH
新店福民辦	QH
新店福民限	QH
新店福民閱	QH
新店中正閱	QI
新店中正視	QI
新店中正開	QI
新店中正借	QI
新店中正罕	QI
新店中正兒	QI
新店中正期	QI
新店中正參	QI
新店中正樂	QI
新店中正辦	QI
新店中正限	QI
新店中正閱	QI
新店仁愛圖	QJ
新店仁愛圖	QJ
新店柴埕圖	QK
新店柴埕視	QK
新店柴埕開	QK
新店柴埕借	QK
新店柴埕罕	QK
新店柴埕兒	QK
新店柴埕期	QK
新店柴埕參	QK
新店柴埕辦	QK
新店柴埕限	QK
新店柴埕圖	QK
新店大鵬圖	QM
新店大鵬視	QM
新店大鵬開	QM
新店大鵬借	QM
新店大鵬罕	QM
新店大鵬兒	QM
新店大鵬期	QM
新店大鵬參	QM
新店大鵬辦	QM
新店大鵬限	QM
新店大鵬圖	QM
新店龜山圖	QN
新店龜山視	QN
新店龜山開	QN
新店龜山借	QN
新店龜山罕	QN
新店龜山兒	QN
新店龜山期	QN
新店龜山參	QN
新店龜山辦	QN
新店龜山限	QN
新店龜山圖	QN
新店三民圖	QO
新店三民視	QO
新店三民開	QO
新店三民借	QO
新店三民罕	QO
新店三民兒	QO
新店三民期	QO
新店三民參	QO
新店三民辦	QO
新店三民限	QO
新店三民圖	QO
新北市青少	QP
青少年圖書	QP
青少年圖書	QP
青少年圖書	QP
青少年圖書	QP
青少年圖書	QP
青少年圖書	QP
青少年圖書	QP
青少年圖書	QP
青少年圖書	QP
青少年圖書	QP
青少年圖書	QP
青少年圖書	QP
青少年圖書	QP
青少年圖書	QP
青少年校園	QP
新北市青少	QP
坪林分館	ZB
坪林視聽室	ZB
坪林開架閱	ZB
坪林借書櫃	ZB
坪林罕用書	ZB
坪林兒童室	ZB
坪林本土語	ZB
坪林期刊室	ZB
坪林參考室	ZB
坪林樂齡專	ZB
坪林特色專	ZB
坪林辦公室	ZB
坪林限制級	ZB
坪林分館取	ZB
烏來分館	ZF
烏來視聽室	ZF
烏來開架閱	ZF
烏來借書櫃	ZF
烏來兒童室	ZF
烏來本土語	ZF
烏來期刊室	ZF
烏來參考室	ZF
烏來樂齡專	ZF
烏來特色專	ZF
烏來辦公室	ZF
烏來限制級	ZF
烏來分館取	ZF
永和分館	FA
永和視聽室	FA
永和開架閱	FA
永和借書櫃	FA
永和兒童室	FA
永和期刊室	FA
永和參考室	FA
永和樂齡專	FA
永和慢讀專	FA
永和辦公室	FA
永和限制級	FA
永和校園C	FA
永和分館取	FA
永和親子圖	FB
永和親子視	FB
永和親子開	FB
永和親子借	FB
永和親子兒	FB
永和親子期	FB
永和親子參	FB
永和親子限	FB
永和親子圖	FB
永和民權分	FC
永和民權視	FC
永和民權開	FC
永和民權借	FC
永和民權幸	FC
永和民權罕	FC
永和民權兒	FC
永和民權本	FC
永和民權期	FC
永和民權參	FC
永和民權樂	FC
永和民權特	FC
永和民權辦	FC
永和民權限	FC
永和民權分	FC
永和忠孝圖	FD
永和忠孝視	FD
永和忠孝開	FD
永和忠孝借	FD
永和忠孝兒	FD
永和忠孝期	FD
永和忠孝參	FD
永和忠孝辦	FD
永和忠孝限	FD
永和忠孝圖	FD
永和保生分	FE
永和保生視	FE
永和保生開	FE
永和保生借	FE
永和保生罕	FE
永和保生兒	FE
永和保生期	FE
永和保生參	FE
永和保生特	FE
永和保生辦	FE
永和保生限	FE
永和保生分	FE
中和員山分	OA
中和員山原	OA
中和員山視	OA
中和員山開	OA
中和員山借	OA
中和員山罕	OA
中和員山兒	OA
中和員山期	OA
中和員山參	OA
中和員山特	OA
中和員山辦	OA
中和員山限	OA
中和員山分	OA
中和大同圖	OB
中和大同視	OB
中和大同開	OB
中和大同借	OB
中和大同罕	OB
中和大同兒	OB
中和大同期	OB
中和大同參	OB
中和大同樂	OB
中和大同辦	OB
中和大同限	OB
中和大同圖	OB
中和分館	OC
中和視聽室	OC
中和開架閱	OC
中和借書櫃	OC
中和罕用書	OC
中和兒童室	OC
中和本土語	OC
中和期刊室	OC
中和參考室	OC
中和樂齡專	OC
中和特色專	OC
中和辦公室	OC
中和限制級	OC
中和校園C	OC
中和分館取	OC
中和行動書	OD
ODBK	OD
中和行動書	OD
土城分館	JA
土城原住民	JA
土城視聽室	JA
土城開架閱	JA
土城借書櫃	JA
土城罕用書	JA
土城兒童室	JA
土城期刊室	JA
土城參考室	JA
土城特色專	JA
土城辦公室	JA
土城限制級	JA
土城校園C	JA
土城分館取	JA
土城清水圖	JB
土城清水視	JB
土城清水開	JB
土城清水借	JB
土城清水罕	JB
土城清水兒	JB
土城清水期	JB
土城清水參	JB
土城清水樂	JB
土城清水辦	JB
土城清水限	JB
土城清水圖	JB
土城柑林埤	JC
土城柑林埤	JC
土城柑林埤	JC
土城柑林埤	JC
土城柑林埤	JC
土城柑林埤	JC
土城柑林埤	JC
土城柑林埤	JC
土城柑林埤	JC
土城柑林埤	JC
土城柑林埤	JC
土城祖田圖	JD
土城祖田視	JD
土城祖田開	JD
土城祖田借	JD
土城祖田兒	JD
土城祖田本	JD
土城祖田期	JD
土城祖田參	JD
土城祖田樂	JD
土城祖田辦	JD
土城祖田限	JD
土城祖田圖	JD
土城親子分	JE
土城親子視	JE
土城親子開	JE
土城親子借	JE
土城親子幸	JE
土城親子罕	JE
土城親子兒	JE
土城親子期	JE
土城親子參	JE
土城親子特	JE
土城親子兒	JE
土城親子辦	JE
土城親子限	JE
土城親子分	JE
三峽分館	CA
三峽原住民	CA
三峽視聽室	CA
三峽開架閱	CA
三峽借書櫃	CA
三峽罕用書	CA
三峽兒童室	CA
三峽本土語	CA
三峽期刊室	CA
三峽參考室	CA
三峽樂齡專	CA
三峽特色專	CA
三峽特色專	CA
三峽在地文	CA
三峽辦公室	CA
三峽限制級	CA
三峽校園C	CA
三峽分館取	CA
三峽北大分	CB
三峽北大視	CB
三峽北大開	CB
三峽北大借	CB
三峽北大幸	CB
三峽北大罕	CB
三峽北大兒	CB
三峽北大期	CB
三峽北大參	CB
三峽北大辦	CB
三峽北大限	CB
三峽北大分	CB
樹林分館	NA
樹林視聽室	NA
樹林開架閱	NA
樹林借書櫃	NA
樹林罕用書	NA
樹林閉架書	NA
樹林兒童室	NA
樹林在地知	NA
樹林期刊室	NA
樹林參考室	NA
樹林樂齡專	NA
樹林辦公室	NA
樹林限制級	NA
樹林分館取	NA
樹林大安圖	NB
樹林大安視	NB
樹林大安開	NB
樹林大安借	NB
樹林大安兒	NB
樹林大安期	NB
樹林大安參	NB
樹林大安辦	NB
樹林大安限	NB
樹林大安圖	NB
樹林柑園圖	NC
樹林柑園視	NC
樹林柑園開	NC
樹林柑園借	NC
樹林柑園罕	NC
樹林柑園兒	NC
樹林柑園期	NC
樹林柑園參	NC
樹林柑園辦	NC
樹林柑園限	NC
樹林柑園圖	NC
樹林三多圖	ND
樹林三多視	ND
樹林三多開	ND
樹林三多借	ND
樹林三多罕	ND
樹林三多兒	ND
樹林三多期	ND
樹林三多參	ND
樹林三多樂	ND
樹林三多辦	ND
樹林三多限	ND
樹林三多圖	ND
樹林樂山圖	NE
樹林樂山視	NE
樹林樂山開	NE
樹林樂山借	NE
樹林樂山罕	NE
樹林樂山兒	NE
樹林樂山期	NE
樹林樂山參	NE
樹林樂山辦	NE
樹林樂山限	NE
樹林樂山圖	NE
樹林保安圖	NF
樹林保安視	NF
樹林保安開	NF
樹林保安借	NF
樹林保安兒	NF
樹林保安期	NF
樹林保安參	NF
樹林保安辦	NF
樹林保安限	NF
樹林彭厝圖	NG
樹林彭厝視	NG
樹林彭厝開	NG
樹林彭厝借	NG
樹林彭厝兒	NG
樹林彭厝本	NG
樹林彭厝期	NG
樹林彭厝參	NG
樹林彭厝特	NG
樹林彭厝辦	NG
樹林彭厝限	NG
樹林彭厝圖	NG
樹林東昇分	NH
樹林東昇視	NH
樹林東昇開	NH
樹林東昇借	NH
樹林東昇閉	NH
樹林東昇兒	NH
樹林東昇期	NH
樹林東昇限	NH
樹林東昇分	NH
鶯歌分館	EA
鶯歌視聽室	EA
鶯歌開架閱	EA
鶯歌借書櫃	EA
鶯歌罕用書	EA
鶯歌兒童室	EA
鶯歌本土語	EA
鶯歌期刊室	EA
鶯歌參考室	EA
鶯歌樂齡專	EA
鶯歌特色專	EA
鶯歌在地文	EA
鶯歌兒童玩	EA
鶯歌辦公室	EA
鶯歌限制級	EA
鶯歌青少年	EA
鶯歌分館取	EA
鶯歌二甲圖	EB
鶯歌二甲視	EB
鶯歌二甲開	EB
鶯歌二甲借	EB
鶯歌二甲罕	EB
鶯歌二甲兒	EB
鶯歌二甲期	EB
鶯歌二甲參	EB
鶯歌二甲辦	EB
鶯歌二甲限	EB
鶯歌二甲圖	EB
三重分館	HA
三重視聽室	HA
三重開架閱	HA
三重借書櫃	HA
三重罕用書	HA
三重兒童室	HA
三重多元文	HA
三重本土語	HA
三重期刊室	HA
三重參考室	HA
三重樂齡專	HA
三重特色專	HA
三重特色專	HA
三重兒童玩	HA
三重辦公室	HA
三重限制級	HA
三重校園C	HA
三重分館取	HA
三重田中分	HB
三重田中視	HB
三重田中開	HB
三重田中借	HB
三重田中罕	HB
三重田中兒	HB
三重田中期	HB
三重田中參	HB
三重田中辦	HB
三重田中限	HB
三重田中分	HB
三重五常分	HC
三重五常視	HC
三重五常開	HC
三重五常借	HC
三重五常罕	HC
三重五常閉	HC
三重五常兒	HC
三重五常期	HC
三重五常參	HC
三重五常辦	HC
三重五常限	HC
三重五常分	HC
三重崇德分	HD
三重崇德視	HD
三重崇德開	HD
三重崇德借	HD
三重崇德罕	HD
三重崇德兒	HD
三重崇德期	HD
三重崇德參	HD
三重崇德辦	HD
三重崇德限	HD
三重崇德分	HD
三重東區分	HE
三重東區視	HE
三重東區開	HE
三重東區借	HE
三重東區罕	HE
三重東區兒	HE
三重東區期	HE
三重東區參	HE
三重東區兒	HE
三重東區辦	HE
三重東區限	HE
三重東區分	HE
三重南區分	HF
三重南區視	HF
三重南區開	HF
三重南區借	HF
三重南區罕	HF
三重南區兒	HF
三重南區期	HF
三重南區參	HF
三重南區樂	HF
三重南區特	HF
三重南區兒	HF
三重南區辦	HF
三重南區限	HF
三重南區分	HF
三重培德分	HG
三重培德視	HG
三重培德開	HG
三重培德借	HG
三重培德罕	HG
三重培德兒	HG
三重培德期	HG
三重培德參	HG
三重培德特	HG
三重培德辦	HG
三重培德限	HG
三重培德分	HG
三重智慧型	HH
三重兒童親	HI
三重兒親視	HI
三重兒親開	HI
三重兒親借	HI
三重兒親兒	HI
三重兒親期	HI
三重兒親參	HI
三重兒親限	HI
新莊福營分	IA
新莊福營視	IA
新莊福營開	IA
新莊福營借	IA
新莊福營罕	IA
新莊福營兒	IA
新莊福營在	IA
新莊福營期	IA
新莊福營參	IA
新莊福營特	IA
新莊福營辦	IA
新莊福營限	IA
新莊福營分	IA
新莊中港分	IC
新莊中港視	IC
新莊中港開	IC
新莊中港借	IC
新莊中港罕	IC
新莊中港兒	IC
新莊中港在	IC
新莊中港期	IC
新莊中港參	IC
新莊中港樂	IC
新莊中港特	IC
新莊中港大	IC
新莊中港辦	IC
新莊中港限	IC
新莊中港校	IC
新莊中港分	IC
新莊分館	ID
新莊藝術圖	ID
新莊視聽室	ID
新莊開架閱	ID
新莊借書櫃	ID
新莊兒童室	ID
新莊期刊室	ID
新莊參考室	ID
新莊特色專	ID
新莊慢讀專	ID
新莊辦公室	ID
新莊限制級	ID
新莊分館取	ID
新莊西盛分	IE
新莊西盛原	IE
新莊西盛視	IE
新莊西盛開	IE
新莊西盛借	IE
新莊西盛兒	IE
新莊西盛期	IE
新莊西盛參	IE
新莊西盛樂	IE
新莊西盛特	IE
新莊西盛辦	IE
新莊西盛限	IE
新莊西盛分	IE
新莊聯合分	IF
新莊聯合視	IF
新莊聯合開	IF
新莊聯合借	IF
新莊聯合兒	IF
新莊聯合本	IF
新莊聯合期	IF
新莊聯合參	IF
新莊聯合特	IF
新莊聯合兒	IF
新莊聯合辦	IF
新莊聯合限	IF
新莊聯合分	IF
新莊裕民分	IG
新莊裕民視	IG
新莊裕民開	IG
新莊裕民借	IG
新莊裕民兒	IG
新莊裕民期	IG
新莊裕民參	IG
新莊裕民特	IG
新莊裕民特	IG
新莊裕民辦	IG
新莊裕民限	IG
新莊裕民分	IG
新莊頭前智	IH
新莊頭前智	IH
新莊頭前智	IH
新莊頭前智	IH
新莊頭前智	IH
泰山分館	LA
泰山視聽室	LA
泰山開架閱	LA
泰山借書櫃	LA
泰山罕用書	LA
泰山兒童室	LA
泰山本土語	LA
泰山期刊室	LA
泰山參考室	LA
泰山樂齡專	LA
泰山特色專	LA
泰山慢讀專	LA
泰山辦公室	LA
泰山限制級	LA
泰山校園C	LA
泰山分館取	LA
泰山貴子分	LB
泰山貴子視	LB
泰山貴子開	LB
泰山貴子借	LB
泰山貴子罕	LB
泰山貴子兒	LB
泰山貴子期	LB
泰山貴子參	LB
泰山貴子特	LB
泰山貴子辦	LB
泰山貴子限	LB
泰山貴子分	LB
泰山親子圖	LC
泰山親子視	LC
泰山親子開	LC
泰山親子借	LC
泰山親子罕	LC
泰山親子兒	LC
泰山親子期	LC
泰山親子參	LC
泰山親子限	LC
泰山親子圖	LC
林口分館	GA
林口視聽室	GA
林口開架閱	GA
林口借書櫃	GA
林口幸福家	GA
林口罕用書	GA
林口兒童室	GA
林口休閒閱	GA
林口本土語	GA
林口期刊室	GA
林口參考室	GA
林口樂齡專	GA
林口套書專	GA
林口特色專	GA
林口辦公室	GA
林口限制級	GA
林口校園C	GA
林口分館取	GA
林口東勢閱	GB
林口東勢期	GB
林口東勢閱	GB
林口西林圖	GC
林口西林視	GC
林口西林開	GC
林口西林借	GC
林口西林兒	GC
林口西林期	GC
林口西林參	GC
林口西林限	GC
林口西林圖	GC
林口區李科	GD
林口李科永	GD
林口李科永	GD
林口李科永	GD
林口李科永	GD
林口李科永	GD
林口李科永	GD
林口李科永	GD
林口李科永	GD
林口李科永	GD
林口李科永	GD
蘆洲長安分	KA
蘆洲長安視	KA
蘆洲長安開	KA
蘆洲長安借	KA
蘆洲長安幸	KA
蘆洲長安罕	KA
蘆洲長安兒	KA
蘆洲長安多	KA
蘆洲長安本	KA
蘆洲長安期	KA
蘆洲長安參	KA
蘆洲長安特	KA
蘆洲長安辦	KA
蘆洲長安限	KA
蘆洲長安分	KA
蘆洲永平分	KC
蘆洲永平視	KC
蘆洲永平開	KC
蘆洲永平借	KC
蘆洲永平罕	KC
蘆洲永平兒	KC
蘆洲永平多	KC
蘆洲永平期	KC
蘆洲永平參	KC
蘆洲永平樂	KC
蘆洲永平辦	KC
蘆洲永平限	KC
蘆洲永平分	KC
蘆洲永安圖	KD
蘆洲永安視	KD
蘆洲永安開	KD
蘆洲永安借	KD
蘆洲永安罕	KD
蘆洲永安兒	KD
蘆洲永安期	KD
蘆洲永安參	KD
蘆洲永安辦	KD
蘆洲永安限	KD
蘆洲永安校	KD
蘆洲永安圖	KD
蘆洲集賢分	KE
蘆洲集賢視	KE
蘆洲集賢開	KE
蘆洲集賢借	KE
蘆洲集賢罕	KE
蘆洲集賢兒	KE
蘆洲集賢期	KE
蘆洲集賢參	KE
蘆洲集賢樂	KE
蘆洲集賢特	KE
蘆洲集賢辦	KE
蘆洲集賢限	KE
蘆洲集賢校	KE
蘆洲集賢分	KE
蘆洲兒童親	KF
蘆洲兒童視	KF
蘆洲兒童開	KF
蘆洲兒童借	KF
蘆洲兒童罕	KF
蘆洲兒童親	KF
蘆洲兒童兒	KF
蘆洲兒童期	KF
蘆洲兒童參	KF
蘆洲兒童兒	KF
蘆洲兒童限	KF
蘆洲兒童親	KF
蘆洲仁愛智	KG
蘆洲仁愛智	KG
蘆洲仁愛智	KG
蘆洲仁愛智	KG
五股分館	BA
五股視聽室	BA
五股開架閱	BA
五股借書櫃	BA
五股罕用書	BA
五股兒童室	BA
五股本土語	BA
五股期刊室	BA
五股參考室	BA
五股樂齡專	BA
五股特色專	BA
五股特色專	BA
五股守讓堂	BASRT
五股辦公室	BA
五股限制級	BA
五股校園C	BA
五股分館取	BA
五股成州圖	BB
五股成州視	BB
五股成州開	BB
五股成州借	BB
五股成州兒	BB
五股成州期	BB
五股成州參	BB
五股成州辦	BB
五股成州限	BB
五股成州圖	BB
五股水碓分	BC
五股水碓視	BC
五股水碓開	BC
五股水碓借	BC
五股水碓罕	BC
五股水碓兒	BC
五股水碓本	BC
五股水碓期	BC
五股水碓參	BC
五股水碓樂	BC
五股水碓特	BC
五股水碓辦	BC
五股水碓限	BC
五股水碓分	BC
五股更新圖	BD
五股更新視	BD
五股更新開	BD
五股更新借	BD
五股更新兒	BD
五股更新期	BD
五股更新參	BD
五股更新辦	BD
五股更新限	BD
五股更新圖	BD
五股成功分	BE
五股成功視	BE
五股成功開	BE
五股成功借	BE
五股成功罕	BE
五股成功兒	BE
五股成功本	BE
五股成功期	BE
五股成功參	BE
五股成功樂	BE
五股成功辦	BE
五股成功限	BE
五股成功分	BE
八里分館	PAL
八里視聽室	PAL
八里開架閱	PAL
八里借書櫃	PAL
八里兒童室	PAL
八里本土語	PAL
八里期刊室	PAL
八里參考室	PAL
八里樂齡專	PAL
八里特色專	PAL
八里辦公室	PAL
八里限制級	PAL
八里分館取	PAL
八里龍形圖	PB
八里龍形視	PB
八里龍形開	PB
八里龍形借	PB
八里龍形兒	PB
八里龍形期	PB
八里龍形參	PB
八里龍形限	PB
八里龍形永	PB
淡水分館[	UA
淡水視聽室	UA
淡水開架閱	UA
淡水借書櫃	UA
淡水罕用書	UA
淡水兒童室	UA
淡水本土語	UA
淡水期刊室	UA
淡水參考室	UA
淡水樂齡專	UA
淡水特色專	UA
淡水辦公室	UA
淡水限制級	UA
淡水青少年	UA
淡水校園C	UA
淡水分館取	UA
淡水竹圍分	UB
淡水竹圍視	UB
淡水竹圍開	UB
淡水竹圍借	UB
淡水竹圍罕	UB
淡水竹圍兒	UB
淡水竹圍期	UB
淡水竹圍參	UB
淡水竹圍特	UB
淡水竹圍兒	UB
淡水竹圍辦	UB
淡水竹圍限	UB
淡水竹圍分	UB
淡水水碓分	UC
淡水水碓視	UC
淡水水碓開	UC
淡水水碓借	UC
淡水水碓罕	UC
淡水水碓兒	UC
淡水水碓期	UC
淡水水碓參	UC
淡水水碓特	UC
淡水水碓兒	UC
淡水水碓辦	UC
淡水水碓限	UC
淡水水碓分	UC
淡水行動書	UD
淡海小書房	UU
淡海小書房	UU
三芝分館	DA
三芝視聽室	DA
三芝開架閱	DA
三芝借書櫃	DA
三芝罕用書	DA
三芝兒童室	DA
三芝本土語	DA
三芝期刊室	DA
三芝參考室	DA
三芝樂齡專	DA
三芝特色專	DA
三芝辦公室	DA
三芝限制級	DA
三芝分館取	DA
石門分館	VA
石門視聽室	VA
石門開架閱	VA
石門借書櫃	VA
石門罕用書	VA
石門兒童室	VA
石門本土語	VA
石門期刊室	VA
石門參考室	VA
石門樂齡專	VA
石門特色專	VA
石門辦公室	VA
石門限制級	VA
石門分館取	VA
新店仁愛視	QJ
新店仁愛開	QJ
新店仁愛借	QJ
新店仁愛罕	QJ
新店仁愛兒	QJ
新店仁愛期	QJ
新店仁愛參	QJ
新店仁愛辦	QJ
新店仁愛限	QJ
蘆洲湧蓮開	KH
蘆洲湧蓮借	KH
蘆洲湧蓮兒	KH
蘆洲湧蓮期	KH
蘆洲湧蓮參	KH
蘆洲湧蓮限	KH
